##########
#   P    #
#        #
#    O   #
#   X    #
#        #
##########
